1 1 1 1 1 1 1 1 1 1 1 1 1 1 1 1 1
1 0 0 1 0 1 0 1 0 1 6 1 0 1 0 0 1
1 1 0 0 0 0 0 0 7 0 0 0 0 0 0 1 1
1 0 0 1 0 1 0 1 5 1 5 1 0 1 0 0 1
1 1 0 0 0 0 0 5 5 0 0 0 0 0 0 1 1
1 0 0 1 0 1 0 1 0 1 0 1 0 1 0 0 1
1 1 0 0 0 0 0 0 0 0 0 0 0 0 0 1 1
1 0 0 1 0 1 0 1 0 1 8 1 0 1 0 0 1
1 1 0 0 0 5 0 0 0 0 5 5 0 0 0 1 1
1 0 0 1 0 1 0 1 0 1 6 1 5 1 0 0 1
1 1 0 0 0 7 5 5 8 5 5 0 0 0 0 1 1
1 0 0 1 0 1 0 1 0 1 0 1 0 1 0 0 1
1 1 1 1 1 1 1 1 1 1 1 1 1 1 1 1 1