1 1 1 1 1 1 1 1 1 1 1 1 1 1 1 1 1
1 0 0 1 0 1 0 1 0 1 8 1 0 1 0 0 1
1 1 0 -1 3 0 0 0 8 0 0 0 0 0 0 1 1
1 0 0 1 0 1 0 1 5 1 5 1 0 1 0 0 1
1 1 0 0 0 0 0 5 5 0 3 0 0 0 0 1 1
1 0 0 1 0 1 0 1 0 1 0 1 0 1 0 0 1
1 1 0 0 0 0 0 0 0 0 0 0 0 0 0 1 1
1 0 0 1 0 1 0 1 0 1 8 1 0 1 0 0 1
1 1 0 0 0 5 0 0 0 0 5 5 0 0 0 1 1
1 0 0 1 0 1 0 1 0 1 6 1 5 1 0 0 1
1 1 0 3 0 9 5 5 7 5 5 0 0 0 2 1 1
1 0 0 1 0 1 0 1 0 1 0 1 0 1 0 0 1
1 1 1 1 1 1 1 1 1 1 1 1 1 1 1 1 1