1 1 1 1 1 1 1 1 1 1 1 1 1 1 1 1 1
1 0 0 0 0 0 0 0 0 0 0 0 0 0 0 0 1
1 0 7 1 0 1 0 1 0 1 0 1 0 1 5 0 1
1 2 0 0 0 0 0 0 0 0 0 0 0 3 0 2 1
1 0 8 1 0 1 0 1 0 1 0 1 0 1 5 0 1
1 0 0 0 0 6 0 0 2 3 0 7 0 0 0 0 1
1 0 1 0 1 0 1 1 5 1 1 0 1 0 1 0 1
1 0 0 0 0 0 1 0 0 0 1 0 0 0 0 0 1
1 0 1 0 1 0 1 0 0 0 1 0 1 0 1 0 1
1 0 0 0 0 0 1 1 1 1 1 0 0 0 0 0 1
1 0 1 0 1 5 5 8 9 9 5 5 1 0 1 0 1
1 0 3 0 0 0 0 5 5 5 0 0 0 0 3 0 1
1 1 1 1 1 1 1 1 1 1 1 1 1 1 1 1 1