1 1 1 1 1 1 1 1 1 1 1 1 1 1 1 1 1
1 0 0 1 0 5 0 0 5 0 0 0 0 -1 1 0 1
1 0 2 0 0 0 1 0 0 0 2 0 0 0 1 0 1
1 0 0 5 0 0 1 0 5 0 0 9 9 1 1 0 1
1 0 3 0 0 0 1 0 0 0 0 0 0 0 0 0 1
1 0 0 5 0 0 1 0 1 0 0 0 0 0 1 1 1
1 0 3 0 0 0 0 0 0 0 0 5 5 0 0 0 1
1 0 9 1 0 0 5 0 0 0 0 0 5 0 0 0 1
1 0 9 1 0 0 7 0 1 0 5 0 5 0 1 5 1
1 0 0 1 0 0 8 0 1 0 5 0 0 0 1 0 1
1 9 1 1 1 6 1 1 1 1 1 0 5 1 1 0 1
1 0 0 0 0 0 1 0 5 0 0 0 0 0 5 0 1
1 1 1 1 1 1 1 1 1 1 1 1 1 1 1 1 1