1 1 1 1 1 1 1 1 1 1 1 1 1 1 1 1 1
1 0 0 0 0 0 0 0 3 0 0 0 0 0 0 0 1
1 0 5 5 5 5 5 5 5 5 5 5 5 5 5 0 1
1 2 0 0 0 0 0 0 0 0 0 0 0 3 5 2 1
1 0 5 5 5 5 5 5 5 5 5 5 5 0 5 0 1
1 0 5 0 0 0 0 0 0 3 0 0 5 0 5 0 1
1 0 5 2 8 6 6 6 6 6 6 2 5 2 5 0 1
1 0 5 0 8 0 0 0 0 0 0 0 5 0 5 0 1
1 0 5 0 8 9 9 9 9 9 9 9 5 0 5 0 1
1 0 5 0 3 0 0 0 0 0 0 0 0 0 5 0 1
1 0 5 5 5 5 5 8 9 9 5 5 5 5 5 0 1
1 0 3 0 0 0 0 0 0 0 0 0 0 0 0 0 1
1 1 1 1 1 1 1 1 1 1 1 1 1 1 1 1 1